*0*;*3*;30
*0*;*1*;10
*1*;*2*;16
*1*;*4*;40
*2*;*4*;20
*4*;*5*;20
*4*;*6*;10
*5*;*6*;5
*6*;*3*;25