*0*;*3*;10
*0*;*5*;1
*1*;*2*;1
*2*;*4*;1
*3*;*4*;1
*3*;*1*;1
*4*;*5*;1
*5*;*4*;1
*5*;*2*;1