*4*;*5*
*5*;*4*
*5*;*2*
*0*;*2*
*0*;*4*
*2*;*3*
*2*;*1*
